58同城: com.wuba
CSDN: net.csdn.csdnplus
Keep: com.gotokeep.keep
Office Mobile: com.microsoft.office.officehub
ofo共享单车|小黄车: so.ofo.labofo
QQ: com.tencent.mobileqq
QQ空间: com.qzone
QQ浏览器: com.tencent.mtt
QQ同步助手: com.tencent.qqpim
QQ音乐: com.tencent.qqmusic
QQ邮箱: com.tencent.androidqqmail
爱奇艺|iqiyi: com.qiyi.video
爱永吉: com.sobey.cloud.webtv.yongji
百词斩: com.jiongji.andriod.card
百度地图: com.baidu.BaiduMap
百度网盘: com.baidu.netdisk
北京地铁: com.subway.bjsubway
哔哩哔哩|bilibili: tv.danmaku.bili
当当: com.dangdang.buy2
滴滴出行: com.sdu.didi.psnger
饿了么: me.ele
谷歌翻译: com.google.android.apps.translate
广发手机银行: com.cgbchina.xpt
今日头条: com.ss.android.article.news
金山词霸: com.kingsoft
京东: com.jingdong.app.mall
酷我音乐: cn.kuwo.player
联通手机营业厅: com.sinovatech.unicom.ui
猫眼: com.sankuai.movie
美团外卖: com.sankuai.meituan.takeoutnew
米家: com.xiaomi.smarthome
摩拜单车: com.mobike.mobikeapp
全民K歌: com.tencent.karaoke
什么值得买: com.smzdm.client.android
手机淘宝: com.taobao.taobao
搜狗输入法: com.sohu.inputmethod.sogou
搜狐视频: com.sohu.sohuvideo
淘票票: com.taobao.movie.android
腾讯视频: com.tencent.qqlive
腾讯手机管家: com.tencent.qqpimsecure
腾讯新闻: com.tencent.news
铁路12306: com.MobileTicket
网易云音乐: com.netease.cloudmusic
微信: com.tencent.mm
微信读书: com.tencent.weread
微云: com.qq.qcloud
唯乐: com.yf.smart.weloopx.dist
喜马拉雅: com.ximalaya.ting.android
小米运动: com.xiaomi.hm.health
新浪微博: com.sina.weibo
邮储银行: com.yitong.mbank.psbc
招商银行: cmb.pb
招商银行掌上生活: com.cmbchina.ccd.pluto.cmbActivity
支付宝: com.eg.android.AlipayGphone
中华万年历: cn.etouch.ecalendar
